1111111111111111111111111
1P00000000000000000000001
1011111111111111111111101
1010000000000000C00000001
1011111111111111111101011
1000000000000000000C000E1
1111111111111111111111111