1111111111111111111111111111
1P000000000000C0000000000001
1111110111111011111111011111
1C00001000000100000101000001
1011101111010111110111101111
101000000001000C0000100000E1
1111111111111111111111111111