111111111111111111111111111111
1P000C000000000000000000000001
101011111011101111101111111101
101000001000100010000000001C01
101110101111011111011110101101
1C0000010001000100000000010001
1111111111111111111111111E1111