1111111111111111111111111111111111
1P0000000000000000000C000000000001
1011111111111011111110111111011101
100000000001C000000010000000001C01
1011111011111111011111101111101111
10000000000000001000000000000000E1
1111111111111111111111111111111111